XXXXXXXXXXXXXXXXXXXXXXXX
X----------------------X
X--------------------G-X
X----------------------X
X----------------------X
X----------------------X
X---X----X----X----X---X
X----------------------X
X----------------------X
X----------------------X
X----------------------X
X-----XX--------XX-----X
X----------------------X
X----------------------X
X----------------------X
X----------------------X
X---X----X----X----X---X
X----------------------X
X----------------------X
X----------------------X
X----------------------X
X-----XX--------XX-----X
X----------------------X
X----------------------X
X----------------------X
X----------------------X
X---X----X----X----X---X
X----------------------X
X----------------------X
X-O--------------------X
X----------------------X
XXXXXXXXXXXXXXXXXXXXXXXX